6 2 2 6 6 6 6 6 6 6 6 6 6 6 6 6
6 2 2 2 2 2 2 2 2 2 2 2 2 2 2 6
6 2 2 2 2 2 2 2 2 5 4 3 2 2 2 6
6 2 2 2 2 2 2 2 2 2 2 2 2 2 2 6
6 2 2 2 2 2 2 2 2 2 2 2 2 2 2 6
6 2 2 2 2 2 2 2 2 2 2 2 2 2 2 6
6 2 2 2 2 2 2 2 2 2 2 2 2 2 2 6
6 2 2 2 2 2 2 2 2 2 2 2 2 2 2 6
6 2 2 2 2 2 5 5 5 5 2 2 2 2 2 6
6 2 2 2 2 2 5 5 5 5 2 2 2 2 2 6
6 2 2 2 2 2 5 5 5 5 2 2 2 2 2 6
6 6 6 6 6 6 6 6 6 6 6 6 6 6 6 6
